publicacaoController => controllers/rgms/PublicacaoController.groovy ;
periodicoController => controllers/rgms/PeriodicoController.groovy ;
conferenciaController => controllers/rgms/ConferenciaController.groovy ;
ferramentaController => controllers/rgms/FerramentaController.groovy ;
teseController => controllers/rgms/TeseController.groovy ;
dissertacaoController => controllers/rgms/DissertacaoController.groovy ;
periodico => domain/rgms/Periodico.groovy ;
conferencia => domain/rgms/Conferencia.groovy ;
ferramenta => domain/rgms/Ferramenta.groovy ;
tese => domain/rgms/Tese.groovy ;
dissertacao => domain/rgms/Dissertacao.groovy ;
listPeriodico => views/periodico/list.gsp ;
showPeriodico => views/periodico/show.gsp ;
createPeriodico => views/periodico/create.gsp ;
editPeriodico => views/periodico/edit.gsp ;
listConferencia => views/conferencia/list.gsp ;
showConferencia => views/conferencia/show.gsp ;
createConferencia => views/conferencia/create.gsp ;
editConferencia => views/conferencia/edit.gsp ;
listFerramenta => views/ferramenta/list.gsp ;
showFerramenta => views/ferramenta/show.gsp ;
createFerramenta => views/ferramenta/create.gsp ;
editFerramenta => views/ferramenta/edit.gsp ;
listDissertacao => views/dissertacao/list.gsp ;
showDissertacao => views/dissertacao/show.gsp ;
createDissertacao => views/dissertacao/create.gsp ;
editDissertacao => views/dissertacao/edit.gsp ;
listTese => views/tese/list.gsp ;
showTese => views/tese/show.gsp ;
createTese => views/tese/create.gsp ;
editTese => views/tese/edit.gsp ;
pdfController => controllers/rgms/PdfController.groovy ;
pdfService => services/rgms/PdfService.groovy ;
messages => i18n/messages.properties ;
urlmappings => conf/UrlMappings.groovy ;
messages_pt_br => i18n/messages_pt_BR.properties ;
formPeriodico => views/periodico/form.gsp ;
formFerramenta => views/ferramenta/form.gsp ;
formConferencia => views/conferencia/form.gsp ;
formTese =>  views/tese/form.gsp ;
formDissertacao =>  views/dissertacao/form.gsp ;
indexPub => views/publicacao/index.gsp ;
publicacao => domain/rgms/Publicacao.groovy ;